
    FOR IMMEDIATE RELEASE
CONTACT: Kevin Madden (857) 288-6390
Boston, MA - Today, Governor Mitt Romney announced the Romney for President Texas Statewide Finance Committee. This group will help Governor Romney raise the resources and build the support needed to campaign in Texas.
"I am pleased to have the support of so many respected leaders in Texas," said Governor Romney. "For many years, they have stood as proud examples of civic and community engagement. Together, they will help our campaign as we communicate a vision for meeting the new generation of challenges confronting our nation."
Governor Romney has traveled to Texas on several occasions to meet with top political and business leaders. He was in the state yesterday for fundraising events, and also visited Texas earlier this month.
Governor Romney's Texas Statewide Finance Committee:
David Baldwin (Houston) - Baldwin is a Managing Director of SCF Partners.
Louis Beecherl, Jr. (Dallas) - Beecherl was a 2000 and 2004 Bush Pioneer and North Texas Finance Chair for Bush-Cheney 2004. He began his professional career in the energy industry, eventually serving as Chairman and CEO of Texas Oil and Gas Corp. from 1957 to 1977.
Larry Benson (San Antonio) - Benson is on the Board of Directors for Lone Star Capital Bank, N.A. He is a car dealership owner and former part time owner of the New Orleans Saints.
Scott Caven (Houston) - Caven is a Managing Director and Regional Manager for Texas of Atlantic Trust Company, a private wealth management company. He is a member of the board of University Texas Regents system.
Joe Dilg (Houston) - Dilg is a Managing Partner of Vinson & Elkins, one of the largest law firms in Texas.
Paul Engler (Amarillo) - Engler is the co-founder and CEO of Cactus Feeders, a large and successful cattle feeding operation. Cactus Feeders is the world's largest privately-owned cattle feeding company.
Jonathan Fairbanks (Houston) - Fairbanks is President of Bassoe Offshore, an international investment and offshore brokerage firm.
James B. Francis, Jr., Romney National Finance Co-Chair (Dallas) - Francis is President of Francis Enterprises, Inc. and a 2000 and 2004 Bush Pioneer. His business includes public affairs consulting, private placement work and investments. He was also State Chairman for Senator Kay Hutchison's last two Senate election campaigns. Francis will also serve as a National Finance Co-Chair for the Romney for President campaign.
Robert Gauntt (Houston) - Gauntt is a founding Partner in Avalon Advisors LP, a Houston based investment management firm.
Doug Hodo, Jr. (Houston) - Hodo is President of McGriff, Seibels & Williams of Texas.
Robert B. Holland, III (Dallas) - Holland is a former U.S. Representative to the World Bank from 2002 to 2006 and a 2000 Bush Pioneer. In January 2007, he was named a Member of the Board of Affiliated Computer Services, Inc., an IT solutions service provider.
Dr. Scott Holliday (Dallas) - Holliday is a practicing anesthesiologist and is a member of Pinnacle Anesthesia Consultants of Dallas.
William Hutchinson (Dallas) - Hutchinson is President of Dunhill Partners, a 23 year-old Dallas commercial real estate brokerage and management firm. The firm both owns and manages a number of significant retail and office properties in Dallas and Fort Worth and suburbs such as Plano, Frisco and Southlake.
Drew Johnson (Dallas) - Johnson is a General Partner at CIC Partners. He previously worked for McKinsey and Company and is a graduate of both Brigham Young University and Harvard Business School.
Walter Johnson (Houston) - Johnson is Founder and Chairman of Amegy Bank, one of the state's largest banks.
David Jones (Houston) - Jones is the Principle and Partner with DINI Partners. He is a member of the George Bush Presidential Library Foundation Advisory Council.
Jim McGrath (Houston) - McGrath is President of CEO Communications in Houston. He served in the George H.W. Bush White House and is currently the speechwriter for the former President.
Joseph Meister (Dallas) - Meister is an attorney with Hughes & Luce, a member of Maverick PAC and an officer of the Republican Lawyers of Dallas.
John Muse (Dallas) - Muse was a Bush Pioneer in 2000. Muse is Chairman of HM Capital Partners, a private equity firm that specializes in leveraged buyouts.
Ross Perot, Jr. (Dallas) - Perot is Chairman of Perot Systems, an Information Technology services provider founded by his father, H. Ross Perot, Sr. He is also the Founder and Chairman of Hillwood Development Company.
Bob Perry (Houston) - Perry is the owner of Perry Homes, one of Texas' largest homebuilding companies.
Kevin Rollins (Austin) - Rollins is the former President and CEO of Dell, Inc.
George Seay (Dallas) - Seay is Co-Founder and CEO of Annandale Capital, a multi-asset class money management firm. He is also Co-Founder and Chairman of Legacy.
L.E. Simmons (Houston) - Simmons is the Founder and President of Houston-based L.E. Simmons & Associations and a 2000 Bush Pioneer.
Matthew Simmons (Houston) - Simmons is Chairman and CEO of Simmons & Company International. Simmons is Chairman of Simmons and Company International, an energy investment bank.
Mark Wallace (Houston) - Wallace is President and CEO of Texas Children's Hospital, the nation's largest children's hospital
Logan Walters (Houston) - Walters is an Associate with SCF Partners and former Assistant to President George W. Bush.
  